NO ./assets/wall_no.png
SO ./assets/wall_so.png
WE ./assets/wall_we.png
EA ./assets/wall_ea.png

F 65,66,65
C 147,150,148

        1111111111111111111111111
        1000000000110000000000S01
        1011000001110000000000001
        100a00000a000000000000001
111111111011000001110000000000001
100000000011000001110111111111111
111101a1111111011100000010001
11110101111111011101010010001
11000000110101011101000010001
10000000000000001001000000001
10000000000000001100010010001
11000001110101011111111100011
11110111 1110101 101111010001
11111111 1111111 111111111111
